# # # # # # # # # 
# P W 0 0 0 0 0 # 
# 0 0 0 0 0 0 0 # 
# 0 0 0 W P 0 0 # 
# 0 0 0 0 0 0 0 # 
# 0 0 0 0 0 W H # 
# # # # # # # # # 
